YYYYYYYYYYYYY
OOOOOOOOOOOOO
GGGGGGGGGGGGG
BBBBBBBBBBBBB
PPPPPPPPPPPPP
RRRRRRRRRRRRR
